0000000000
0001111000
0001011110
0001010010
0211101110
0000300110
0000101010
0000114110
0000000000
