0000000000
0001111000
0001311110
0001310010
0222131110
0222303110
0000101310
0000114110
0000000000
