1111111111
1110000111
1110000001
1110400001
1110401101
1222040001
1222414001
1111010401
1111008001
1111111111
