111111
112201
111001
104001
104011
180011
111111
