1,1,1,1,1,1,1,1,1,1
1,1,1,0,0,0,0,1,1,1
1,1,1,0,0,0,0,1,1,1
1,1,1,0,4,1,1,1,1,1
1,1,1,0,4,1,1,1,1,1
1,2,2,2,0,4,0,0,0,1
1,2,2,2,4,1,4,0,0,1
1,1,1,1,0,1,0,4,0,1
1,1,1,1,0,0,8,0,0,1
1,1,1,1,1,1,1,1,1,1
